NO ressources/tex_north.xpm
SO ressources/tex_south.xpm
WE ressources/tex_west.xpm
EA ressources/tex_east.xpm

C 25,30,250
F 220,100,250

111111111111111111111111111111
100000000000000000000000000011
10E011111111111111111111110011
101000000000000000000001010011
101111111111111111111101010011
101000000000000000000101010011
101011111111111111110101010011
101000000000000000010101010011
101111111011111111010101010011
100000001010000001010101010011
111101101011111101010101010011
100101001000000101010100000011
101101101011110101010111111011
101000101000010101010000000011
101011101111110101011111110011
101000000000010101000000010011
10101111111101D101111110010011
100000000000010100000010000011
111111111111110111111111111111
111111111111110111111111111111
111111111111110111111111111111
100000000000000000000000000001
100000000000000000000000000001
100000000000000000000000000001
111111111111111111111111111111